1111111111111111111
100CC0P10000Z000001
10111111Z000000ZZ11
1000000100100000001
10B00Z011000B000001
1010100100111100001
1010100Z00000010001
101O01111B111110101
1E10000000Z00010001
1111111111111111111