1111111111111111111
100000P10000Z000001
10111111Z000000ZZ11
10000C0100100000001
10B00Z011O00B000001
1010100100111100001
1010100Z00000010001
101O01111B111110101
1C10000000Z00C100E1
1111111111111111111