1111111111111111111
1P01C000000000000C1
1101111101111111101
10Z0100Z00000Z00001
1101101011101111111
1Z000Z1000000000001
1010101101111111111
1010101000000000001
1C1C0C10000000000E1
1111111111111111111