1111111111111111111
1P0C0000000C0000001
1ECC1100X0101111101
1000000100000000001
1010101011101010101
1010101010101010101
1010101010101010101
101010101X101010101
1010001000000010001
1111111111111111111