1111111111111111111
1P0CX00000C00000C01
1111110000101101101
1000C00000000X00001
1X1000C011101010101
10101C1010101010101
1X101010101X1010101
1010101010101110101
101000100C0000100E1
1111111111111111111