1111111111111111111
1CCCPCC1C000000C001
100000000000Z000001
10000100C0000000001
10000000000000C0001
100010Z000Z00000001
1C0000Z00000Z010001
1000101010101110101
101000100C0000100E1
1111111111111111111