111111
1P0001
111101
100001
101111
111111