1111111111111111111
1CCCPCC1C000000C001
100Z000000000000001
10000000C0000000001
1000000010000C00001
1000100000000000001
1C00000000000010001
1000101010101110101
101000100C0000100E1
1111111111111111111