1111111111111111111
1C00P00100000000001
100Z100000000000001
10Z00Z0000000000001
1CCC000010000000001
1000100000000000001
1000000000000010001
1000101010101110101
10100010000000100E1
1111111111111111111